200131041134300
012110200340421
010324031432332
323032221142133
422043443311124
004324231014042
124444203313241
311122200100310
144414222424112
330220440344432
034031322002311
123100404342303
